B 0 B B B B 0 B
M M P 0 0 P M M
B 0 M M M M 0 B
M M P 0 0 P M M
B 0 M M M M 0 B
M M M M M M M M
